18 44 44 44 44 44 44 44 44 44 44 44 44 44 44 44 44 33 33 33 44 44 44 44 44 44 44 44 44 20
14 0 0 0 0 0 0 0 0 0 0 0 0 0 0 0 0 0 0 0 0 0 0 0 0 0 0 0 0 14
14 0 0 0 0 0 0 0 0 0 0 0 0 0 0 0 0 0 0 0 0 0 0 0 0 0 0 0 0 14
14 0 0 0 0 0 0 55 0 0 0 0 18 18 81 82 82 82 83 19 20 0 0 0 0 0 7 0 0 14
14 0 0 0 0 0 0 46 0 0 0 0 43 44 44 44 44 44 44 44 45 0 0 46 0 18 27 0 0 14
14 0 0 18 19 19 19 19 20 0 0 0 0 0 0 0 0 0 0 0 0 0 0 18 19 33 34 0 0 14
14 0 0 25 44 33 33 33 44 20 0 0 0 0 0 0 48 62 0 0 0 0 0 26 27 0 0 0 0 14
14 55 0 25 27 0 0 0 32 44 20 0 0 0 43 44 44 19 44 45 0 0 18 33 34 0 0 0 0 14
14 0 0 32 27 0 0 0 0 0 32 44 20 0 0 0 0 0 0 0 0 18 34 0 0 0 0 62 0 14
14 0 0 0 21 0 0 0 0 0 0 32 44 85 86 86 86 86 86 86 87 26 0 0 0 0 0 0 0 14
14 0 0 0 0 0 0 49 0 0 0 0 26 26 26 26 26 26 26 26 26 26 0 0 0 0 0 0 0 14
14 0 0 0 0 0 0 18 20 0 0 0 26 0 0 0 0 0 0 26 26 26 26 44 45 0 0 0 0 14
14 92 93 46 0 0 43 44 34 0 0 18 34 0 62 0 0 0 0 0 0 0 14 0 0 0 0 0 0 14
14 44 44 44 44 44 44 0 0 0 0 14 0 0 49 0 0 0 0 0 0 0 14 0 70 0 55 0 0 14
14 0 0 0 0 0 44 0 0 0 0 25 44 44 44 44 44 44 45 0 0 0 14 0 77 0 46 0 0 14
14 0 0 0 0 0 44 0 0 0 26 34 0 0 0 0 0 0 0 0 0 0 25 44 44 44 45 0 0 14
14 0 55 43 44 44 34 0 0 18 34 0 0 0 0 0 0 0 0 0 0 0 27 0 0 0 0 0 0 14
14 0 0 0 0 0 0 0 0 21 0 0 0 0 43 34 20 0 0 0 18 33 34 0 0 0 0 0 0 14
14 0 46 0 0 0 0 0 0 0 0 0 0 0 0 55 14 0 0 0 14 0 0 0 0 0 0 0 0 14
14 44 45 0 0 0 0 18 0 49 0 48 0 0 0 0 14 0 0 43 34 0 0 62 28 0 0 0 0 14
14 0 0 0 0 0 0 25 19 18 33 33 33 81 82 83 14 0 0 0 0 0 0 28 0 0 0 0 0 14
14 0 0 0 0 0 18 26 33 33 0 0 32 33 33 33 34 0 0 0 46 0 0 0 0 47 0 0 0 14
14 0 0 0 0 49 18 33 0 0 0 62 0 0 0 0 0 0 43 19 43 44 85 86 87 44 44 0 69 14
14 33 78 79 80 33 33 33 0 0 0 0 49 0 0 0 47 0 0 44 44 44 44 44 44 44 44 0 76 14
32 44 44 44 44 44 44 44 44 44 44 44 44 44 44 44 44 44 44 44 44 44 44 44 44 44 44 44 44 34
