3 3 3 3 3 3 3 3 3 3 3 3 3 3 3 3 3 3 3 3
3 0 0 0 0 0 0 0 0 0 0 0 0 0 0 0 0 0 0 3
3 0 0 0 0 0 0 0 0 0 0 0 0 0 0 0 0 0 0 3
3 0 0 0 0 0 0 1 2 0 0 0 1 4 4 4 1 0 0 3
3 2 2 0 0 0 0 0 0 0 0 1 1 0 0 0 0 0 0 3
3 0 0 0 0 0 0 0 0 0 0 0 0 0 0 0 1 1 1 3
3 0 0 0 0 0 0 0 0 3 2 2 4 4 4 2 0 0 0 3
3 0 0 0 0 0 5 0 0 3 0 0 0 0 0 0 0 0 1 3
3 0 0 1 1 1 1 1 1 3 1 0 0 0 0 0 0 0 0 3
3 0 0 0 0 0 0 0 0 0 0 0 1 1 1 1 1 1 0 3
3 0 0 0 0 0 0 0 0 0 0 1 3 3 3 3 3 3 0 3
3 1 1 1 1 1 1 1 1 0 0 3 3 3 3 3 3 3 0 3
3 3 3 3 3 3 3 3 3 0 0 3 3 3 3 3 3 3 0 3
3 0 0 0 0 0 0 0 0 0 0 0 0 3 0 0 0 3 0 3
3 1 1 1 0 0 0 0 0 0 0 0 0 3 0 0 0 3 0 3
3 0 0 3 1 0 0 0 0 0 0 0 0 3 3 0 0 0 0 3
3 1 0 3 3 3 3 3 3 0 0 0 0 3 3 3 3 3 0 3
3 3 0 0 0 0 0 0 0 0 0 0 0 3 3 3 3 3 0 3
3 0 0 0 0 0 0 0 0 0 0 0 0 0 0 0 0 0 0 3
3 3 3 3 3 3 4 4 4 3 3 4 4 4 3 3 3 3 3 3
