18 19 19 19 19 19 19 19 19 19 19 19 19 19 19 19 19 19 19 19 19 19 19 19 19 19 19 19 19 20
25 0 0 0 0 0 0 0 0 0 0 0 0 0 0 0 0 0 0 0 0 0 0 0 0 0 0 0 0 27
25 0 0 0 0 0 0 0 0 0 0 0 0 0 0 0 0 0 0 0 0 0 0 0 0 0 0 0 0 27
25 0 0 0 0 0 0 55 0 0 0 0 0 0 0 0 0 0 0 0 0 0 0 0 0 0 69 0 70 27
25 0 0 0 0 0 18 19 20 0 0 0 0 62 0 0 0 0 0 0 0 0 49 0 0 0 76 0 77 27
25 0 0 0 0 0 32 26 26 19 19 19 19 44 44 44 44 44 44 44 44 44 44 44 44 44 44 44 44 27
25 0 62 0 0 0 0 32 33 33 33 33 34 0 0 0 0 0 0 0 0 0 0 0 0 0 0 0 0 27
25 19 19 20 0 0 0 0 0 0 0 0 0 0 0 0 0 0 46 0 0 0 0 0 0 0 0 0 0 27
25 19 19 27 0 0 0 0 0 0 0 0 0 0 0 0 0 18 19 20 0 0 0 0 0 0 0 0 0 27
25 19 19 27 0 51 0 0 0 0 48 0 0 0 0 0 0 25 26 26 20 0 0 0 0 0 0 0 0 27
25 33 33 33 44 44 44 44 44 44 44 44 44 44 44 44 44 33 33 33 33 33 33 33 33 45 0 0 0 27
25 0 0 0 0 0 0 0 0 0 0 0 0 0 0 0 0 0 0 0 0 0 0 0 0 0 0 0 0 27
25 0 0 0 0 55 0 0 0 0 0 0 0 0 0 0 0 0 0 0 0 0 0 0 0 0 0 0 0 27
25 0 0 0 43 44 44 44 44 44 19 20 0 0 0 62 0 0 0 48 0 0 0 47 0 0 0 49 0 27
25 0 0 0 0 0 0 0 0 0 32 33 33 33 33 33 33 33 33 33 33 33 33 33 19 19 19 19 19 27
25 0 0 0 0 0 0 0 0 0 0 0 0 0 0 0 0 0 0 0 0 0 0 0 32 33 26 26 26 27
25 0 0 0 0 0 0 0 0 0 0 0 0 0 0 0 0 0 0 0 0 0 0 0 0 0 32 33 33 27
25 0 0 49 0 0 0 0 0 48 0 0 0 0 0 0 0 0 0 0 0 0 0 0 0 0 0 0 0 27
25 19 19 19 19 19 19 19 19 19 20 0 0 18 85 86 86 87 20 0 46 0 0 0 0 0 0 0 0 27
25 0 0 0 0 0 0 0 0 32 33 33 33 33 33 33 33 33 33 33 33 34 0 0 0 0 0 0 0 27
25 46 0 0 0 0 0 0 0 0 0 0 0 0 0 0 0 0 0 0 0 0 0 0 0 0 0 55 0 27
25 44 44 44 44 44 44 45 0 0 0 0 0 0 0 0 0 0 0 0 0 0 0 0 0 0 18 19 19 27
25 0 0 0 0 0 0 0 0 0 0 0 0 55 0 0 0 0 62 0 0 0 0 0 0 0 25 26 26 27
25 0 0 0 0 46 0 0 0 0 0 18 81 82 82 83 19 19 78 79 79 80 20 0 50 0 25 33 33 27
32 33 33 33 33 33 33 33 33 33 33 33 33 33 33 33 33 33 33 33 33 33 33 33 33 33 33 33 33 34
