33 33 33 33 33 33 33 33 33 33 33 33 33 33 33 33 33 33 33 33 33 33 33 33 33 33 33 33 33 33
33 0 0 0 0 0 0 0 0 0 0 0 0 0 0 0 0 0 0 0 0 0 0 0 0 0 0 0 0 33
33 0 0 0 0 0 0 0 0 0 0 0 0 0 0 0 62 0 0 0 0 0 0 0 0 0 0 0 0 33
33 0 0 0 0 0 0 55 0 0 0 0 0 0 0 0 0 0 0 0 0 0 0 0 0 0 26 0 0 33
33 0 0 0 0 0 0 0 0 0 0 0 0 26 81 82 82 82 83 26 0 0 0 0 0 26 26 0 0 33
33 0 0 26 44 44 44 44 26 0 0 0 0 0 0 0 0 0 0 0 0 0 0 26 26 26 26 0 0 33
33 0 0 44 44 44 44 44 44 44 0 0 0 0 0 0 55 0 0 0 0 0 0 26 26 0 0 0 0 33
33 0 0 44 44 0 0 0 44 44 44 0 0 0 0 0 0 0 0 0 0 0 26 26 26 0 0 0 0 26
33 0 0 44 44 0 0 0 0 0 44 44 44 0 0 0 0 0 0 0 0 26 26 0 0 0 0 62 0 33
33 0 0 0 44 0 0 0 0 0 0 44 44 85 86 86 86 86 86 86 87 26 0 0 0 0 0 0 0 33
33 0 0 0 0 0 0 0 0 0 0 0 26 26 26 26 26 26 26 26 26 26 0 0 0 0 0 0 0 33
33 0 0 0 0 0 0 44 44 0 0 0 26 0 0 0 0 0 0 26 26 26 26 26 26 0 0 0 0 33
33 0 0 51 0 0 44 44 44 0 0 26 26 0 62 0 0 0 0 0 0 0 26 0 0 0 0 0 0 33
33 44 44 44 44 44 44 0 0 0 0 26 0 0 0 0 0 0 0 0 0 0 26 0 70 0 55 0 0 33
33 0 0 0 0 0 44 0 0 0 0 26 26 26 26 26 26 26 26 0 0 0 26 0 77 0 0 0 0 33
33 0 0 0 0 0 44 0 0 0 26 26 26 26 26 26 0 0 26 26 0 0 26 26 26 26 26 0 0 33
33 0 0 44 44 44 44 0 0 26 26 0 0 0 0 0 0 0 0 0 0 0 26 0 0 0 0 0 0 33
33 0 0 0 0 0 0 0 0 26 0 0 0 0 0 0 0 0 0 0 26 26 26 0 0 0 0 0 0 33
33 0 0 0 0 0 0 0 0 0 0 0 0 0 0 0 44 0 0 0 26 26 26 0 0 0 0 0 0 33
33 44 44 44 44 0 0 0 0 0 0 0 51 0 0 0 44 0 0 0 0 26 26 0 0 62 0 0 0 33
33 0 0 0 0 0 0 0 0 33 33 33 33 81 82 83 44 0 0 0 0 0 0 0 0 0 0 0 0 33
33 0 0 55 0 0 0 33 33 33 0 0 33 33 33 44 44 0 0 0 0 0 0 0 0 0 0 0 0 33
33 0 0 0 0 0 33 33 0 0 0 62 0 0 0 0 0 0 0 44 44 44 85 86 87 44 44 0 69 33
33 33 78 79 80 33 33 33 0 0 0 0 0 0 0 0 0 0 0 44 44 44 44 44 44 44 44 0 76 33
33 33 33 33 33 33 33 33 33 33 33 33 33 33 33 33 33 33 33 33 33 33 33 33 33 33 33 33 33 33
