8 44 44 44 44 44 44 44 44 44 44 44 44 44 44 44 44 44 44 44 44 44 44 44 44 44 44 44 44 7
14 0 0 0 0 0 0 0 0 69 0 0 0 0 0 0 0 0 0 0 0 70 0 0 0 0 0 0 0 14
14 0 55 0 0 0 0 0 0 76 0 55 0 49 0 0 0 0 0 0 0 77 0 0 0 0 0 0 0 14
14 0 48 0 0 0 0 43 44 44 44 44 44 44 44 44 44 44 44 44 44 44 44 44 44 45 0 0 0 14
14 44 44 45 0 0 0 0 0 0 0 0 0 0 0 0 0 0 0 0 0 0 0 0 0 0 0 0 0 14
14 0 0 0 0 0 0 0 0 0 0 0 0 0 0 0 0 0 0 0 0 0 0 0 0 0 0 0 0 14
14 0 46 0 0 0 0 0 0 0 0 0 0 0 0 62 0 0 0 0 0 0 0 0 49 0 0 0 55 14
14 44 44 44 45 0 0 0 0 0 0 0 0 0 0 48 0 0 0 0 0 0 0 18 20 0 0 0 0 14
14 0 0 0 0 0 0 0 0 18 85 86 86 87 19 19 19 81 82 82 82 82 83 26 27 14 0 0 0 14
14 0 62 0 0 0 0 43 44 44 44 44 44 44 44 44 44 44 44 44 44 44 44 44 44 44 20 0 0 14
14 0 0 0 0 0 0 0 0 0 0 0 0 0 0 0 0 0 0 0 0 0 0 0 0 0 14 92 93 14
26 19 20 0 0 0 0 0 0 0 49 0 0 0 0 0 0 0 0 0 0 0 0 0 0 0 32 33 33 19
19 19 27 0 0 18 44 44 44 44 44 44 44 44 44 44 19 20 0 46 0 0 0 0 0 0 0 0 0 14
26 19 19 19 33 34 0 0 0 0 0 0 0 0 0 0 32 33 33 33 33 20 0 51 0 0 0 0 0 14
14 0 0 0 0 0 0 0 0 0 0 0 0 0 0 0 0 0 0 0 0 32 44 44 20 0 0 0 0 14
14 0 0 55 0 0 0 0 0 62 0 0 0 0 0 0 0 0 0 0 0 0 0 0 32 44 45 0 0 14
14 0 43 44 45 0 0 0 0 0 0 0 46 0 0 0 0 0 0 0 55 0 0 0 0 0 0 0 0 14
14 0 0 0 0 0 0 18 19 19 19 19 19 19 19 19 19 19 20 0 0 0 0 0 0 0 0 48 0 14
14 0 49 0 0 0 32 33 33 33 33 33 33 33 33 33 33 33 33 33 33 33 20 0 46 0 18 19 19 19
14 44 44 45 0 0 0 0 0 0 0 0 0 0 0 0 0 0 0 0 0 0 32 33 33 33 33 33 33 19
14 0 0 0 0 0 0 0 62 0 46 0 55 0 0 0 0 0 0 0 0 0 0 0 0 0 0 0 0 14
14 0 0 0 0 0 0 43 44 44 44 19 19 19 20 0 0 0 0 0 0 0 0 0 0 0 0 62 0 14
14 0 0 48 0 0 0 0 0 0 0 0 0 0 0 0 0 0 49 0 0 0 48 0 0 0 0 0 0 14
26 19 19 19 19 19 81 82 82 82 82 82 82 82 82 83 19 19 19 19 19 19 19 20 0 0 0 48 0 14
43 44 44 44 44 44 44 44 44 44 44 44 44 44 44 44 44 44 44 44 44 44 44 44 44 44 44 44 44 45
