19 19 19 19 19 19 19 19 19 19 19 19 19 19 19 19 19 19 19 19 19 19 19 19 19 19 19 19 19 20 
18 0 0 0 0 0 0 0 0 0 0 0 0 0 0 0 0 0 0 0 0 0 0 0 0 0 0 0 0 20 
18 0 0 0 0 0 0 0 0 0 0 0 0 0 0 0 0 0 0 0 0 0 0 0 0 0 0 0 0 20 
18 0 0 0 0 0 0 55 0 0 0 0 0 0 0 0 0 0 0 0 0 0 0 0 0 0 69 0 70 20 
18 0 0 0 0 0 19 19 19 0 0 0 0 62 0 0 0 0 0 0 0 0 49 0 0 0 76 0 77 20 
18 0 0 0 0 0 19 19 19 19 19 19 19 19 19 19 19 19 19 19 19 19 19 19 19 19 19 19 19 20 
18 0 62 0 0 0 0 19 19 19 19 19 19 0 0 0 0 0 0 0 0 0 0 0 0 0 0 0 0 20 
18 19 19 19 0 0 0 0 0 0 0 0 0 0 0 0 0 0 46 0 0 0 0 0 0 0 0 0 0 20 
18 19 19 19 0 0 0 0 0 0 0 0 0 0 0 0 0 19 19 19 0 0 0 0 0 0 0 0 0 20 
18 19 19 19 0 51 0 0 0 0 48 0 0 0 0 0 0 19 19 19 19 0 0 0 0 0 0 0 0 20 
18 19 19 19 19 19 19 19 19 19 19 19 19 19 19 19 19 19 19 19 19 19 19 19 19 19 0 0 0 20 
18 0 0 0 0 0 0 0 0 0 0 0 0 0 0 0 0 0 0 0 0 0 0 0 0 0 0 0 0 20 
18 0 0 0 0 55 0 0 0 0 0 0 0 0 0 0 0 0 0 0 0 0 0 0 0 0 0 0 0 20 
18 0 0 0 19 19 19 19 19 19 19 19 0 0 0 62 0 0 0 48 0 0 0 47 0 0 0 49 0 20 
18 0 0 0 0 0 0 0 0 0 19 19 19 19 19 19 19 19 19 19 19 19 19 19 19 19 19 19 19 20 
18 0 0 0 0 0 0 0 0 0 0 0 0 0 0 0 0 0 0 0 0 0 0 0 19 19 19 19 19 20 
18 0 0 0 0 0 0 0 0 0 0 0 0 0 0 0 0 0 0 0 0 0 0 0 0 0 19 19 19 20 
18 0 0 49 0 0 0 0 0 48 0 0 0 0 0 0 0 0 0 0 0 0 0 0 0 0 0 0 0 20 
18 32 32 32 32 32 32 32 32 33 34 0 0 0 0 0 0 0 0 0 46 0 0 0 0 0 0 0 0 20 
18 0 0 0 0 0 0 0 0 32 32 32 32 32 85 86 86 87 32 32 33 34 0 0 0 0 0 0 0 27 
18 46 0 0 0 0 0 0 0 0 0 0 0 0 0 0 0 0 0 0 0 0 0 0 0 0 0 55 0 34 
18 32 32 32 32 32 33 34 0 0 0 0 0 0 0 0 0 0 0 0 0 0 0 0 0 0 18 19 19 20 
18 0 0 0 0 0 0 0 0 0 0 0 0 55 0 0 0 0 62 0 0 0 0 0 0 0 25 26 26 20 
18 0 0 0 0 46 0 0 0 0 0 0 0 0 0 0 0 0 0 0 0 0 0 50 0 0 32 33 33 27 
32 33 34 34 34 34 34 34 34 34 34 34 81 82 82 83 34 34 78 79 79 80 34 34 34 34 34 33 34 34
