18 44 44 44 44 44 44 44 44 44 44 44 44 44 44 44 44 44 44 44 44 44 44 44 44 44 44 44 44 20 
14 0 0 0 0 0 0 0 0 0 0 0 0 0 0 0 0 0 0 0 0 0 0 0 0 0 0 0 0 14 
14 0 0 0 0 0 0 0 0 0 0 0 0 0 0 0 0 0 0 0 0 0 0 0 0 0 0 0 0 14 
14 0 0 0 0 0 0 55 0 0 0 0 0 0 0 0 0 0 0 0 0 0 0 0 69 0 0 70 0 14 
14 0 0 0 0 0 18 19 20 0 0 0 0 62 0 0 0 0 0 0 0 0 49 0 76 0 0 77 0 14 
14 0 0 0 0 0 32 26 26 26 26 26 26 44 44 44 44 44 44 44 44 44 44 44 44 44 44 44 44 14 
14 46 62 0 0 0 0 32 33 33 33 33 34 0 0 0 0 0 0 0 0 0 0 0 0 0 0 0 0 14 
25 19 19 20 0 0 0 0 0 0 0 0 0 0 0 0 0 0 46 0 0 0 0 0 0 0 0 0 0 14 
25 19 19 27 0 0 0 0 0 0 0 0 55 0 0 0 0 18 26 20 0 0 0 0 0 0 0 0 0 14 
25 19 19 27 0 51 0 0 0 0 48 0 0 0 0 0 0 25 26 26 20 0 0 47 0 0 0 0 0 14 
25 33 33 33 44 44 44 44 44 44 44 44 44 44 44 44 44 33 33 33 33 44 44 44 44 45 0 0 0 14 
14 0 0 0 0 0 0 0 0 0 0 0 0 0 0 0 0 0 0 0 0 0 0 0 0 0 0 0 0 14 
14 0 0 0 0 55 0 0 0 0 0 0 0 0 0 0 0 0 0 0 0 0 0 0 0 0 0 0 0 14 
14 0 0 0 43 44 44 44 44 44 19 20 0 0 0 62 0 0 0 48 0 0 0 47 0 0 0 49 0 14 
14 0 0 0 0 0 0 0 0 0 32 33 44 44 44 44 44 44 44 44 44 44 44 44 19 19 19 19 19 14 
14 0 50 0 0 0 0 0 0 0 0 0 0 0 0 0 0 0 0 0 0 0 0 0 43 26 26 26 26 14 
14 51 51 51 0 0 0 0 0 0 0 0 0 0 0 0 0 0 0 0 0 0 0 0 0 0 43 33 33 14 
25 44 44 44 44 44 44 44 44 44 44 44 44 44 44 44 44 44 44 45 0 0 0 0 0 0 0 0 0 14 
14 0 0 0 0 0 0 0 0 0 0 0 0 0 0 0 0 0 0 0 0 0 0 0 0 0 0 62 0 14 
14 0 55 0 0 0 0 0 0 0 0 0 49 0 0 0 0 0 46 0 0 0 0 0 0 0 0 0 0 14 
14 46 0 0 0 0 0 0 0 0 0 43 44 44 45 0 0 43 44 44 44 45 0 0 0 0 0 0 49 14 
25 44 44 44 44 44 44 45 0 0 0 0 0 0 0 0 0 0 0 0 0 0 0 0 0 0 18 19 19 27 
14 0 0 0 0 0 0 0 0 0 0 0 0 55 0 0 0 0 62 0 0 0 0 0 0 0 25 26 26 27 
14 0 0 0 0 46 0 0 0 0 18 78 79 79 80 19 19 81 82 82 83 20 0 50 0 0 25 33 33 27 
32 44 44 44 44 44 44 44 44 44 44 44 44 44 44 44 44 44 44 44 44 44 44 44 44 44 33 33 33 14
