26 26 26 26 26 26 26 19 26 26 26 26 26 26 26 26 26 26 26 26 26 26 26 26 26 26 26 26 26 26 
26 0 0 0 0 0 0 0 0 69 0 0 0 0 0 0 0 0 0 0 0 0 0 0 0 0 0 0 0 26 
26 0 55 0 0 0 0 0 0 76 0 55 0 0 0 0 0 0 0 0 0 0 0 70 0 0 48 0 0 26 
26 0 0 0 0 0 0 44 44 44 44 44 44 0 0 0 0 0 0 0 0 0 0 77 0 44 44 0 0 19 
44 44 44 44 0 0 0 0 0 0 0 0 0 0 0 0 0 46 0 0 0 44 44 44 44 44 0 0 0 19 
26 0 0 0 0 0 0 0 0 0 0 0 0 44 44 44 44 44 44 44 44 44 44 44 0 0 0 0 0 26 
26 0 46 0 0 0 0 0 0 0 0 0 0 0 0 0 0 0 0 0 0 0 0 0 0 0 0 0 62 26 
26 44 44 44 44 0 0 0 0 0 0 0 0 0 0 0 0 0 0 55 0 0 0 0 0 0 0 0 0 26 
26 0 0 0 0 0 0 0 0 0 0 0 0 0 0 0 0 0 0 0 0 0 0 0 46 0 0 0 0 19 
26 0 62 0 0 19 19 19 81 82 82 82 83 19 19 19 19 85 86 86 86 87 19 19 19 19 19 0 0 26 
26 0 0 0 0 0 0 0 0 0 0 0 0 0 0 0 0 0 0 0 0 0 0 0 0 0 19 0 0 26 
26 19 19 0 0 0 0 0 0 0 0 0 0 0 0 0 0 0 0 0 0 0 0 0 0 0 19 19 19 19 
19 19 19 0 0 19 19 19 19 19 19 19 19 19 19 19 19 19 0 46 0 0 0 0 0 0 0 0 0 26 
26 19 19 19 19 19 0 0 0 0 0 0 0 0 0 0 19 19 19 19 19 19 0 51 0 0 0 0 0 26 
26 0 0 0 0 0 0 0 0 0 0 0 0 0 0 0 0 0 0 0 0 19 19 19 19 0 0 0 0 26 
26 0 0 0 0 0 0 0 0 62 0 0 0 0 0 0 0 0 0 0 0 0 0 0 19 19 19 0 0 26 
26 0 0 0 0 0 0 0 0 0 0 0 46 0 0 50 0 0 0 0 55 0 0 0 0 0 0 0 0 26 
26 0 0 0 0 0 0 19 19 19 19 19 19 19 19 19 19 19 19 0 0 0 0 0 0 0 0 0 0 26 
26 0 0 0 0 0 19 19 19 19 19 19 19 19 19 19 19 19 19 19 19 19 19 0 46 0 19 19 19 19 
26 0 0 0 0 19 19 0 0 0 0 0 0 0 0 0 0 0 0 0 0 0 19 19 19 19 19 19 19 19 
26 0 0 0 0 0 0 0 0 62 46 0 0 0 0 0 0 0 0 0 0 0 0 0 0 0 0 0 0 26 
26 0 0 0 0 0 0 0 43 44 44 45 0 55 0 0 0 0 0 0 0 0 0 0 0 0 0 0 0 26 
26 0 0 0 0 0 0 0 0 0 0 0 0 0 0 0 0 0 0 0 0 0 48 0 0 0 0 0 0 26 
26 19 19 19 19 19 81 82 82 82 82 82 82 82 82 83 19 19 19 19 19 19 19 19 0 0 0 0 0 26 
26 26 26 26 26 26 26 26 26 26 26 26 26 26 26 26 26 26 26 26 26 26 26 26 26 26 26 26 26 26
